################################
#                              #
## ############ ######## #####B#
## ############ ######## ####  #
## #                           #
## # ###########################
#    ##
A ######
